"filename", "language", "HTML", "Markdown", "CSS", "XML", "Less", "comment", "blank", "total"
"/Users/haley/front-end-notes/01. while循环/03 - 综合练习-ATM.html", "HTML", 75, 0, 0, 0, 0, 0, 4, 79
"/Users/haley/front-end-notes/01. while循环/while循环.html", "HTML", 64, 0, 0, 0, 0, 0, 7, 71
"/Users/haley/front-end-notes/01. while循环/作业.html", "HTML", 96, 0, 0, 0, 0, 0, 31, 127
"/Users/haley/front-end-notes/01. while循环/运算符.html", "HTML", 21, 0, 0, 0, 0, 0, 1, 22
"/Users/haley/front-end-notes/01. while循环/退出循环: break.html", "HTML", 23, 0, 0, 0, 0, 0, 3, 26
"/Users/haley/front-end-notes/02. for循环/01 - 基本使用.html", "HTML", 41, 0, 0, 0, 0, 0, 5, 46
"/Users/haley/front-end-notes/02. for循环/02 - 嵌套循环.html", "HTML", 69, 0, 0, 0, 0, 0, 6, 75
"/Users/haley/front-end-notes/03. 数组/01 - 基本使用.html", "HTML", 40, 0, 0, 0, 0, 0, 7, 47
"/Users/haley/front-end-notes/03. 数组/02 - 求值.html", "HTML", 35, 0, 0, 0, 0, 0, 5, 40
"/Users/haley/front-end-notes/03. 数组/03⭐️ - 增删改查.html", "HTML", 61, 0, 0, 0, 0, 1, 8, 70
"/Users/haley/front-end-notes/03. 数组/04 - 柱状体案例.html", "HTML", 63, 0, 0, 0, 0, 0, 5, 68
"/Users/haley/front-end-notes/03. 数组/05 - 冒泡排序.html", "HTML", 35, 0, 0, 0, 0, 0, 2, 37
"/Users/haley/front-end-notes/03. 数组/06 - 作业.html", "HTML", 120, 0, 0, 0, 0, 0, 16, 136
"/Users/haley/front-end-notes/04. 函数/01 - 基本概念.html", "HTML", 69, 0, 0, 0, 0, 0, 7, 76
"/Users/haley/front-end-notes/04. 函数/02 - 函数传参.html", "HTML", 59, 0, 0, 0, 0, 0, 9, 68
"/Users/haley/front-end-notes/04. 函数/03 - 函数数组.html", "HTML", 37, 0, 0, 0, 0, 0, 1, 38
"/Users/haley/front-end-notes/04. 函数/04⭐️ - 返回值.html", "HTML", 29, 0, 0, 0, 0, 0, 1, 30
"/Users/haley/front-end-notes/04. 函数/05 - 函数求值.html", "HTML", 49, 0, 0, 0, 0, 0, 1, 50
"/Users/haley/front-end-notes/04. 函数/06 - 作用域.html", "HTML", 46, 0, 0, 0, 0, 0, 6, 52
"/Users/haley/front-end-notes/04. 函数/07 - 立即执行函数.html", "HTML", 33, 0, 0, 0, 0, 0, 3, 36
"/Users/haley/front-end-notes/04. 函数/08 - 练习：转换秒.html", "HTML", 30, 0, 0, 0, 0, 0, 1, 31
"/Users/haley/front-end-notes/04. 函数/09 - 逻辑&& 和 ||.html", "HTML", 29, 0, 0, 0, 0, 0, 6, 35
"/Users/haley/front-end-notes/04. 函数/10 - 隐式转换.html", "HTML", 25, 0, 0, 0, 0, 0, 0, 25
"/Users/haley/front-end-notes/04. 函数/11- 作业.html", "HTML", 87, 0, 0, 0, 0, 0, 15, 102
"/Users/haley/front-end-notes/05.对象/01 - 基本概念.html", "HTML", 72, 0, 0, 0, 0, 0, 8, 80
"/Users/haley/front-end-notes/05.对象/02⭐️ - 遍历对象.html", "HTML", 52, 0, 0, 0, 0, 0, 4, 56
"/Users/haley/front-end-notes/05.对象/03 - ⭐️渲染对象.html", "HTML", 40, 0, 0, 0, 0, 0, 3, 43
"/Users/haley/front-end-notes/05.对象/04 - 取数API.html", "HTML", 50, 0, 0, 0, 0, 0, 8, 58
"/Users/haley/front-end-notes/05.对象/05 - 猜数字游戏.html", "HTML", 54, 0, 0, 0, 0, 0, 8, 62
"/Users/haley/front-end-notes/05.对象/06 - 获取随机颜色.html", "HTML", 60, 0, 0, 0, 0, 0, 4, 64
"/Users/haley/front-end-notes/05.对象/07 - 数据类型.html", "HTML", 18, 0, 0, 0, 0, 0, 0, 18
"/Users/haley/front-end-notes/05.对象/test.html", "HTML", 108, 0, 0, 0, 0, 0, 13, 121
"/Users/haley/front-end-notes/06.webAPI/01 - 修改DOM基础.html/01 - 变量声明.html", "HTML", 17, 0, 0, 0, 0, 0, 1, 18
"/Users/haley/front-end-notes/06.webAPI/01 - 修改DOM基础.html/02 - 获取DOM.html", "HTML", 55, 0, 0, 0, 0, 0, 9, 64
"/Users/haley/front-end-notes/06.webAPI/01 - 修改DOM基础.html/03 - 修改DOM内容.html", "HTML", 63, 0, 0, 0, 0, 3, 13, 79
"/Users/haley/front-end-notes/06.webAPI/01 - 修改DOM基础.html/04 - 修改DOM样式.html", "HTML", 27, 0, 0, 0, 0, 0, 1, 28
"/Users/haley/front-end-notes/06.webAPI/01 - 修改DOM基础.html/05 - 类名修改样式.html", "HTML", 58, 0, 0, 0, 0, 0, 8, 66
"/Users/haley/front-end-notes/06.webAPI/01 - 修改DOM基础.html/06 - 轮播图.html", "HTML", 142, 0, 0, 0, 0, 0, 24, 166
"/Users/haley/front-end-notes/06.webAPI/01 - 修改DOM基础.html/07 - 修改表单.html", "HTML", 34, 0, 0, 0, 0, 3, 11, 48
"/Users/haley/front-end-notes/06.webAPI/01 - 修改DOM基础.html/08 - 自定义属性.html", "HTML", 24, 0, 0, 0, 0, 0, 0, 24
"/Users/haley/front-end-notes/06.webAPI/02 - 间隔函数(timer)/01 - 基本语法.html", "HTML", 32, 0, 0, 0, 0, 0, 3, 35
"/Users/haley/front-end-notes/06.webAPI/02 - 间隔函数(timer)/02 - 注册条款案例.html", "HTML", 33, 0, 0, 0, 0, 0, 6, 39
"/Users/haley/front-end-notes/06.webAPI/02 - 间隔函数(timer)/03 - 自动轮播图.html", "HTML", 163, 0, 0, 0, 0, 0, 20, 183
"/Users/haley/front-end-notes/06.webAPI/02 - 间隔函数(timer)/04 - 走时钟案例.html", "HTML", 55, 0, 0, 0, 0, 0, 6, 61
"/Users/haley/front-end-notes/06.webAPI/02 - 间隔函数(timer)/05 - 轮播图作业.html", "HTML", 115, 0, 0, 0, 0, 0, 12, 127
"/Users/haley/front-end-notes/07.事件/01 - 事件监听.html", "HTML", 55, 0, 0, 0, 0, 0, 7, 62
"/Users/haley/front-end-notes/07.事件/02 - 随机点名.html", "HTML", 98, 0, 0, 0, 0, 0, 18, 116
"/Users/haley/front-end-notes/07.事件/03 - 回收机制和L0.html", "HTML", 42, 0, 0, 0, 0, 0, 5, 47
"/Users/haley/front-end-notes/07.事件/04 - 鼠标事件汇总.html", "HTML", 22, 0, 0, 0, 0, 0, 3, 25
"/Users/haley/front-end-notes/07.事件/05 - 轮播图功能汇总.html", "HTML", 191, 0, 0, 0, 0, 0, 24, 215
"/Users/haley/front-end-notes/07.事件/06 - 焦点事件.html", "HTML", 90, 0, 0, 0, 0, 0, 14, 104
"/Users/haley/front-end-notes/07.事件/07 - 键盘事件.html", "HTML", 28, 0, 0, 0, 0, 0, 3, 31
"/Users/haley/front-end-notes/07.事件/08 - 多条评论回车发布案例.html", "HTML", 145, 0, 0, 0, 0, 0, 21, 166
"/Users/haley/front-end-notes/07.事件/08 - 评论回车发布案例.html", "HTML", 157, 0, 0, 0, 0, 0, 31, 188
"/Users/haley/front-end-notes/07.事件/09 - this指向.html", "HTML", 31, 0, 0, 0, 0, 0, 7, 38
"/Users/haley/front-end-notes/07.事件/10 - 回调函数.html", "HTML", 28, 0, 0, 0, 0, 0, 1, 29
"/Users/haley/front-end-notes/07.事件/11 - tab栏综合案例.html", "HTML", 107, 0, 0, 0, 0, 0, 19, 126
"/Users/haley/front-end-notes/07.事件/作业/04-显示隐藏密码/仿京东显示隐藏密码.html", "HTML", 72, 0, 0, 0, 0, 0, 12, 84
"/Users/haley/front-end-notes/07.事件/作业/css/7.3/common.css", "CSS", 0, 0, 12750, 0, 0, 51, 2411, 15212
"/Users/haley/front-end-notes/07.事件/作业/css/7.3/index.css", "CSS", 0, 0, 230, 0, 0, 2, 50, 282
"/Users/haley/front-end-notes/07.事件/作业/同意协议.html", "HTML", 95, 0, 0, 0, 0, 3, 7, 105
"/Users/haley/front-end-notes/07.事件/作业/手机验证码.html", "HTML", 36, 0, 0, 0, 0, 0, 3, 39
"/Users/haley/front-end-notes/07.事件/作业/随机显示图片.html", "HTML", 43, 0, 0, 0, 0, 0, 5, 48
"/Users/haley/front-end-notes/08.事件流/01 - ⭐️全选案例.html", "HTML", 103, 0, 0, 0, 0, 0, 15, 118
"/Users/haley/front-end-notes/08.事件流/02 - 捕获和冒泡.html", "HTML", 53, 0, 0, 0, 0, 0, 8, 61
"/Users/haley/front-end-notes/08.事件流/03 - ⭐️tab栏切换进阶.html", "HTML", 97, 0, 0, 0, 0, 2, 18, 117
"/Users/haley/front-end-notes/08.事件流/04 - 事件委托.html", "HTML", 64, 0, 0, 0, 0, 0, 11, 75
"/Users/haley/front-end-notes/08.事件流/05 - 阻止默认行为.html", "HTML", 22, 0, 0, 0, 0, 0, 1, 23
"/Users/haley/front-end-notes/08.事件流/06 - 页面加载事件.html", "HTML", 28, 0, 0, 0, 0, 0, 2, 30
"/Users/haley/front-end-notes/08.事件流/07 - scroll, resize, offsettop.html", "HTML", 70, 0, 0, 0, 0, 0, 12, 82
"/Users/haley/front-end-notes/08.事件流/09 - 头部导航滚动.html", "HTML", 80, 0, 0, 0, 0, 0, 9, 89
"/Users/haley/front-end-notes/08.事件流/09 - 电梯导航/css/common.css", "CSS", 0, 0, 570, 0, 0, 162, 127, 859
"/Users/haley/front-end-notes/08.事件流/09 - 电梯导航/css/index.css", "CSS", 0, 0, 705, 0, 0, 9, 128, 842
"/Users/haley/front-end-notes/08.事件流/09 - 电梯导航/电梯导航.html", "HTML", 1208, 0, 0, 0, 0, 79, 24, 1311
"/Users/haley/front-end-notes/08.事件流/10 - bilibili导航滑动.html/03-m-bilibili/css/index.css", "CSS", 0, 0, 107, 0, 0, 0, 1, 108
"/Users/haley/front-end-notes/08.事件流/10 - bilibili导航滑动.html/03-m-bilibili/fonts/iconfont.css", "CSS", 0, 0, 138, 0, 0, 0, 43, 181
"/Users/haley/front-end-notes/08.事件流/10 - bilibili导航滑动.html/03-m-bilibili/fonts/iconfont.svg", "XML", 0, 0, 0, 61, 0, 3, 89, 153
"/Users/haley/front-end-notes/08.事件流/10 - bilibili导航滑动.html/03-m-bilibili/index.html", "HTML", 59, 0, 0, 0, 0, 10, 1, 70
"/Users/haley/front-end-notes/08.事件流/10 - bilibili导航滑动.html/03-m-bilibili/less/base.less", "Less", 0, 0, 0, 0, 29, 1, 5, 35
"/Users/haley/front-end-notes/08.事件流/10 - bilibili导航滑动.html/03-m-bilibili/less/index.less", "Less", 0, 0, 0, 0, 87, 5, 11, 103
"/Users/haley/front-end-notes/08.事件流/10 - 滑动导航.html", "HTML", 69, 0, 0, 0, 0, 0, 2, 71
"/Users/haley/front-end-notes/README.md", "Markdown", 0, 2, 0, 0, 0, 0, 1, 3
"/Users/haley/front-end-notes/密码框练习.html", "HTML", 60, 0, 0, 0, 0, 0, 4, 64
"/Users/haley/front-end-notes/随机点菜.html", "HTML", 146, 0, 0, 0, 0, 14, 22, 182
"Total", "-", 5807, 2, 14500, 61, 116, 348, 3487, 24321