"filename", "language", "HTML", "CSS", "JavaScript", "comment", "blank", "total"
"/Users/haley/front-end-notes/08.事件流/01 - ⭐️全选案例 copy.html", "HTML", 87, 0, 0, 0, 10, 97
"/Users/haley/front-end-notes/08.事件流/11 - CSS伪类选择器.html", "HTML", 30, 0, 0, 0, 3, 33
"/Users/haley/front-end-notes/08.事件流/11 - 作业/电梯导航.html", "HTML", 85, 0, 0, 0, 23, 108
"/Users/haley/front-end-notes/08.事件流/11 - 作业/购物车加减.html", "HTML", 55, 0, 0, 0, 11, 66
"/Users/haley/front-end-notes/09 - 时间事件/01 - 实例化日期.html", "HTML", 56, 0, 0, 0, 9, 65
"/Users/haley/front-end-notes/09 - 时间事件/02 - 时间的简写.html", "HTML", 41, 0, 0, 0, 7, 48
"/Users/haley/front-end-notes/09 - 时间事件/03 - 时间戳(倒计时).html", "HTML", 16, 0, 0, 0, 0, 16
"/Users/haley/front-end-notes/10-节点查找/01 - 父子节点.html", "HTML", 37, 0, 0, 0, 5, 42
"/Users/haley/front-end-notes/10-节点查找/02 - ⭐️新增节点.html", "HTML", 28, 0, 0, 0, 3, 31
"/Users/haley/front-end-notes/10-节点查找/02 - 新增节点.html", "HTML", 30, 0, 0, 0, 4, 34
"/Users/haley/front-end-notes/10-节点查找/03 - 克隆节点.htm", "HTML", 27, 0, 0, 0, 0, 27
"/Users/haley/front-end-notes/10-节点查找/04 - 删除节点.html", "HTML", 20, 0, 0, 0, 0, 20
"/Users/haley/front-end-notes/10-节点查找/05 - 重绘repaint&回流reflow.html", "HTML", 13, 0, 0, 0, 3, 16
"/Users/haley/front-end-notes/11 - 移动端事件/01 - 移动端基础事件.html", "HTML", 27, 0, 0, 0, 0, 27
"/Users/haley/front-end-notes/11 - 移动端事件/02 - swiper插件.html", "HTML", 105, 0, 0, 1, 11, 117
"/Users/haley/front-end-notes/11 - 移动端事件/03 - 录入学生信息 copy.html", "HTML", 49, 0, 0, 13, 6, 68
"/Users/haley/front-end-notes/11 - 移动端事件/03 - 录入学生信息.html", "HTML", 128, 0, 0, 13, 12, 153
"/Users/haley/front-end-notes/11 - 移动端事件/css-学生信息/index.css", "CSS", 0, 68, 0, 0, 3, 71
"/Users/haley/front-end-notes/11 - 移动端事件/css/swiper.css", "CSS", 0, 499, 0, 32, 2, 533
"/Users/haley/front-end-notes/11 - 移动端事件/css/swiper.min.css", "CSS", 0, 1, 0, 11, 1, 13
"/Users/haley/front-end-notes/11 - 移动端事件/js/swiper.esm.browser.bundle.js", "JavaScript", 0, 0, 7573, 379, 639, 8591
"/Users/haley/front-end-notes/11 - 移动端事件/js/swiper.esm.browser.bundle.min.js", "JavaScript", 0, 0, 1, 12, 1, 14
"/Users/haley/front-end-notes/11 - 移动端事件/js/swiper.esm.bundle.js", "JavaScript", 0, 0, 6828, 319, 616, 7763
"/Users/haley/front-end-notes/11 - 移动端事件/js/swiper.esm.js", "JavaScript", 0, 0, 6809, 319, 617, 7745
"/Users/haley/front-end-notes/11 - 移动端事件/js/swiper.js", "JavaScript", 0, 0, 7745, 379, 679, 8803
"/Users/haley/front-end-notes/11 - 移动端事件/js/swiper.min.js", "JavaScript", 0, 0, 1, 12, 1, 14
"/Users/haley/front-end-notes/12 - BOM同步异步.html/01 - BOM.html", "HTML", 13, 0, 0, 0, 0, 13
"/Users/haley/front-end-notes/12 - BOM同步异步.html/02 - setTimeout.html", "HTML", 22, 0, 0, 0, 1, 23
"/Users/haley/front-end-notes/12 - BOM同步异步.html/03 - 同步和异步.html", "HTML", 32, 0, 0, 0, 3, 35
"/Users/haley/front-end-notes/12 - BOM同步异步.html/04 - location.html", "HTML", 27, 0, 0, 0, 2, 29
"/Users/haley/front-end-notes/12 - BOM同步异步.html/05 - navigator.html", "HTML", 16, 0, 0, 0, 0, 16
"/Users/haley/front-end-notes/12 - BOM同步异步.html/06 - history.html", "HTML", 17, 0, 0, 0, 0, 17
"/Users/haley/front-end-notes/12 - BOM同步异步.html/07 - ⭐️localStorage.html", "HTML", 42, 0, 0, 0, 8, 50
"/Users/haley/front-end-notes/12 - BOM同步异步.html/08 - map, joint.html", "HTML", 25, 0, 0, 0, 4, 29
"Total", "-", 1028, 568, 28957, 1490, 2684, 34727